111111111111111111
1P0000CCCCCC0000E1
111111111111111111