111111111111111111
1P0001C0000C000001
111000C0000C000001
110000C0000C000001
100000C0000C000111
100000CCCCCC0000E1
111111111111111111