111111111111111111
1P0000C0000C000E01
100C0000C000CC0001
111111111111111111