11111111111111111111111111111111
1P0000000000C0C0C0C0C0C0C0000011
11111111111100000000000000010001
110000C0000C0C0C0C0C0C0C00000011
10C00000000000011111111111111111
10000000C0C0C0C0C0C0C00000C00C01
1110000000001111111111111111C0C1
1100000C0C0C00000000001C0C000001
10000000000000000000001011111111
100000C0C0C0C0C0C0C0C010C00000E1
11111111111111111111111111111111